1111111111111
1E100CC010001
10000100C0001
1PC10100CE001
1111111111111
1111111111111
1E100CC010001
10000100C0001
10C10100CE001
1111111111111