1111111111111
10010000000C1
10E0001011001
1000110000001
1111111111111