1111111111111
1E100C00100C1
1000010010001
1PC10W000E001
1111111111111